30,8
000000000000000000000000000000
000000111111111111111110000000
000000100000000000000000000000
000000100011111000010000000000
000000100000021000010000000000
000000100000001000010000000000
000000100000111000010000000000
000000000000000000000000000000
/