8,6
01000102
01010101
01010001
00010011
10111000
11111001
/